9.ox
o..ooo..o...........o..o...
................o..........
....o.......o......o.......
....o.oooo.......o.........
..........o................
.......o.....oo.........o..
......oo............o......
o.......................o..
.....o.o.......o...o......o
